name Dooom 2
win 5
##################################
#............####................#
#G........##########...........G.#
#.....................E..........#
#................................#
#..#...................G.........#
#................................#
#........######..................#
#................................#
#............G...................#
#................................#
#......................G.........#
##################################