name Dooom 1
win 6
#######################
#....#...#G#..#.......#
#.................E...#
#.....................#
###........G.....#....#
#......##..##........##
#............#........#
#.......G.............#
#................######
#######################